540000100.img
541010010.img
541010100.img
541000200.img
541020610.img
551030007.img
500020200.img
551000200.img
500020400.img
500000000.img
541020000.img
551030005.img
551030015.img
541000000.img
541020700.img
540010002.img
541010110.img
551030013.img
551030000.img
551030010.img
551010000.img
541000100.img
541000300.img
551030009.img
551030012.img
551030100.img
500010100.img
541020100.img
541010020.img
551030008.img
551020000.img
540000300.img
540010000.img
500020000.img
540000200.img
541010050.img
500020101.img
551030001.img
541020500.img
541020400.img
551030018.img
540010100.img
541010030.img
540010101.img
541010000.img
550000200.img
550000300.img
550000400.img
551000000.img
551000100.img
541020600.img
551030011.img
541020200.img
540020000.img
500010000.img
550000000.img
551030003.img
540000000.img
540010001.img
551030006.img
551030020.img
500020300.img
551030004.img
551030002.img
551030019.img
551030014.img
500020100.img
541020300.img
541020800.img
551030016.img
551030017.img
540020100.img
541010040.img
550000100.img
541010060.img
551030200.img
