700000000.img
780000001.img
782000001.img
782000000.img
702090302.img
701010321.img
701000200.img
749020920.img
741000204.img
709000400.img
702300003.img
741000201.img
700000101.img
702100000.img
702300007.img
702090303.img
702010000.img
700000200.img
702070400.img
701010322.img
741000200.img
701010400.img
749020800.img
702050000.img
702090202.img
749020600.img
702090201.img
702030000.img
702040000.img
749020910.img
702060000.img
702070100.img
741000208.img
701010320.img
701010200.img
749020100.img
701000203.img
749020200.img
702090103.img
749020300.img
749040101.img
702090203.img
702000000.img
702300001.img
701010100.img
701010300.img
701010310.img
702200001.img
702300006.img
749020500.img
702300002.img
781000000.img
702020000.img
780000002.img
709000604.img
749040100.img
702070300.img
701000100.img
701010500.img
702090400.img
781000002.img
749020000.img
702090102.img
702090301.img
701010323.img
701010324.img
741000202.img
701000210.img
701000201.img
701000000.img
741000207.img
701010000.img
709000605.img
709000700.img
749020900.img
741000205.img
702080000.img
749020400.img
780000003.img
749020700.img
781000001.img
780000006.img
702090101.img
702300000.img
780000005.img
702300005.img
702300008.img
749040102.img
749030000.img
700000100.img
702300010.img
781000003.img
780000004.img
701010600.img
780000000.img
741000203.img
741000206.img
702070200.img
702300004.img
702300009.img
701000202.img
782000002.img
