001020500.img
000010000.img
001020000.img
001000002.img
000030001.img
000000000.img
001020200.img
001020300.img
001000003.img
002000001.img
002010000.img
001000000.img
000050000.img
001020100.img
000020000.img
000030000.img
001010100.img
001020400.img
001000001.img
001010200.img
001010000.img
001010300.img
002000000.img
001010400.img
000040000.img
