300000002.img
300000100.img
300000000.img
300010300.img
300000001.img
300010000.img
300000012.img
300010100.img
300030100.img
300010200.img
300000010.img
300010400.img
300020100.img
300030000.img
300020200.img
300000011.img
300020000.img
