682000600.img
600010400.img
677000013.img
600010200.img
600020400.img
600010003.img
682000800.img
682000404.img
674030300.img
682000502.img
600020300.img
674030000.img
682000100.img
677000003.img
682000200.img
680100002.img
682000900.img
677000000.img
600010500.img
600010004.img
682000305.img
682000602.img
600000000.img
682000603.img
600010002.img
682000604.img
682000401.img
682000303.img
682000405.img
680100001.img
682000301.img
600010100.img
600010001.img
677000008.img
677000009.img
682000304.img
682000306.img
677000010.img
600020600.img
677000001.img
682000504.img
674030100.img
682000300.img
682000000.img
677000007.img
682000501.img
600010005.img
600010600.img
682000302.img
600020200.img
680100003.img
682000506.img
677000006.img
682000400.img
680100000.img
682000402.img
600020500.img
677000011.img
682000503.img
682000406.img
682000500.img
682000606.img
682000403.img
677000005.img
600000001.img
682000505.img
677000012.img
600010300.img
682000601.img
600020100.img
674030200.img
677000004.img
682000700.img
600020000.img
682000605.img
677000002.img
600010000.img
