801020000.img
800020400.img
800020300.img
800010100.img
800020000.img
803011000.img
801030000.img
803100000.img
801000001.img
800020130.img
801000200.img
803000400.img
803001200.img
803011121.img
801000000.img
803000800.img
801000002.img
801000100.img
803000510.img
809000101.img
801000210.img
800010001.img
889100022.img
801000110.img
889100010.img
803000520.img
803001400.img
803011120.img
800020100.img
803000519.img
800020110.img
801000300.img
800010000.img
803011300.img
803001122.img
803000505.img
803200000.img
889100021.img
803001100.img
803011200.img
889100012.img
803011400.img
803000700.img
801010000.img
803001140.img
889100020.img
803010900.img
803001110.img
809000201.img
810000000.img
800030000.img
889100100.img
803001121.img
889100011.img
803010800.img
809030000.img
803000900.img
803000500.img
803000502.img
800000000.img
803011150.img
803010700.img
803001000.img
889100002.img
800020120.img
803000501.img
803000509.img
803001300.img
803011100.img
800020101.img
889100000.img
803011122.img
889100001.img
803011130.img
800020200.img
803001130.img
803011110.img
803001150.img
803011140.img
803001120.img
